a_m_00_att01.x	b_m.x
a_m_00_att02.x	b_m.x
a_m_00_att03.x	b_m.x
a_m_00_run.x	b_m.x
a_m_00_stay.x	b_m.x
a_m_00_stemina.x	b_m.x
a_m_00_strock.x	b_m.x
a_m_00_walk.x	b_m.x
a_m_01_att01.x	b_m.x
a_m_01_att02.x	b_m.x
a_m_01_att03.x	b_m.x
a_m_01_run.x	b_m.x
a_m_01_stay.x	b_m.x
a_m_01_stemina.x	b_m.x
a_m_01_strock.x	b_m.x
a_m_01_walk.x	b_m.x
a_m_02_att01.x	b_m.x
a_m_02_att02.x	b_m.x
a_m_02_att03.x	b_m.x
a_m_02_run.x	b_m.x
a_m_02_stay.x	b_m.x
a_m_02_stemina.x	b_m.x
a_m_02_strock.x	b_m.x
a_m_02_walk.x	b_m.x
a_m_03_att01.x	b_m.x
a_m_03_att02.x	b_m.x
a_m_03_att03.x	b_m.x
a_m_03_run.x	b_m.x
a_m_03_stay.x	b_m.x
a_m_03_stemina.x	b_m.x
a_m_03_strock.x	b_m.x
a_m_03_walk.x	b_m.x
a_m_04_att01.x	b_m.x
a_m_04_att02.x	b_m.x
a_m_04_att03.x	b_m.x
a_m_04_run.x	b_m.x
a_m_04_stay.x	b_m.x
a_m_04_stemina.x	b_m.x
a_m_04_strock.x	b_m.x
a_m_04_walk.x	b_m.x
a_m_05_att01.x	b_m.x
a_m_05_att02.x	b_m.x
a_m_05_att03.x	b_m.x
a_m_05_run.x	b_m.x
a_m_05_stay.x	b_m.x
a_m_05_stemina.x	b_m.x
a_m_05_strock.x	b_m.x
a_m_05_walk.x	b_m.x
a_m_06_att01.x	b_m.x
a_m_06_att02.x	b_m.x
a_m_06_att03.x	b_m.x
a_m_06_run.x	b_m.x
a_m_06_stay.x	b_m.x
a_m_06_stemina.x	b_m.x
a_m_06_strock.x	b_m.x
a_m_06_walk.x	b_m.x
a_m_07_att01.x	b_m.x
a_m_07_att02.x	b_m.x
a_m_07_att03.x	b_m.x
a_m_07_run.x	b_m.x
a_m_07_stay.x	b_m.x
a_m_07_stemina.x	b_m.x
a_m_07_strock.x	b_m.x
a_m_07_walk.x	b_m.x
a_m_08_att01.x	b_m.x
a_m_08_att02.x	b_m.x
a_m_08_att03.x	b_m.x
a_m_08_run.x	b_m.x
a_m_08_stay.x	b_m.x
a_m_08_stemina.x	b_m.x
a_m_08_strock.x	b_m.x
a_m_08_walk.x	b_m.x
a_m_09_att01.x	b_m.x
a_m_09_att02.x	b_m.x
a_m_09_att03.x	b_m.x
a_m_09_run.x	b_m.x
a_m_09_stay.x	b_m.x
a_m_09_stemina.x	b_m.x
a_m_09_strock.x	b_m.x
a_m_09_walk.x	b_m.x
a_m_10_att01.x	b_m.x
a_m_10_run.x	b_m.x
a_m_10_stay.x	b_m.x
a_m_10_stemina.x	b_m.x
a_m_10_strock.x	b_m.x
a_m_10_walk.x	b_m.x
a_m_11_att01.x	b_m.x
a_m_11_att02.x	b_m.x
a_m_11_att03.x	b_m.x
a_m_11_run.x	b_m.x
a_m_11_stay.x	b_m.x
a_m_11_stemina.x	b_m.x
a_m_11_strock.x	b_m.x
a_m_11_walk.x	b_m.x
a_m_as_bok.x	b_m.x
a_m_as_ghung.x	b_m.x
a_m_as_gigwan.x	b_m.x
a_m_as_gkbh.x	b_m.x
a_m_as_hyulgi.x	b_m.x
a_m_as_hyulsi.x	b_m.x
a_m_as_jbwbs.x	b_m.x
a_m_as_jilyuckchim.x	b_m.x
a_m_as_jilyung.x	b_m.x
a_m_as_medit.x	b_m.x
a_m_as_sooho.x	b_m.x
a_m_as_speed.x	b_m.x
a_m_as_suhowhayum.x	b_m.x
a_m_as_susal.x	b_m.x
a_m_as_ung.x	b_m.x
a_m_as_ung01.x	b_m.x
a_m_as_ungchook.x	b_m.x
a_m_as_whayumsa.x	b_m.x
a_m_as_young.x	b_m.x
a_m_bit.x	b_m.x
a_m_die.x	b_m.x
a_m_d_lose.x	b_m.x
a_m_d_win.x	b_m.x
a_m_e_001.x	b_m.x
a_m_e_002.x	b_m.x
a_m_e_003.x	b_m.x
a_m_e_005.x	b_m.x
a_m_e_007.x	b_m.x
a_m_e_008.x	b_m.x
a_m_e_009.x	b_m.x
a_m_e_010.x	b_m.x
a_m_e_011.x	b_m.x
a_m_e_012.x	b_m.x
a_m_e_013.x	b_m.x
a_m_e_014.x	b_m.x
a_m_e_015.x	b_m.x
a_m_e_016.x	b_m.x
a_m_e_017.x	b_m.x
a_m_e_018.x	b_m.x
a_m_e_019.x	b_m.x
a_m_fs_backbo.x	b_m.x
a_m_fs_backchigi.x	b_m.x
a_m_fs_bangtan.x	b_m.x
a_m_fs_bekhojang.x	b_m.x
a_m_fs_boong.x	b_m.x
a_m_fs_chilsung.x	b_m.x
a_m_fs_choopoong.x	b_m.x
a_m_fs_chulsango.x	b_m.x
a_m_fs_chumgoong.x	b_m.x
a_m_fs_daepok.x	b_m.x
a_m_fs_danchim.x	b_m.x
a_m_fs_dolkyuk.x	b_m.x
a_m_fs_ggakji.x	b_m.x
a_m_fs_gwunpoong.x	b_m.x
a_m_fs_hoejungak.x	b_m.x
a_m_fs_jikyuck.x	b_m.x
a_m_fs_junbang.x	b_m.x
a_m_fs_kyukjinpa.x	b_m.x
a_m_fs_manwal.x	b_m.x
a_m_fs_medit.x	b_m.x
a_m_fs_moogong.x	b_m.x
a_m_fs_nantajung.x	b_m.x
a_m_fs_pal.x	b_m.x
a_m_fs_poklyul.x	b_m.x
a_m_fs_psgumgang.x	b_m.x
a_m_fs_push.x	b_m.x
a_m_fs_risingtk.x	b_m.x
a_m_fs_saja.x	b_m.x
a_m_fs_santa.x	b_m.x
a_m_fs_sghjgak.x	b_m.x
a_m_fs_speed.x	b_m.x
a_m_fs_speedkick.x	b_m.x
a_m_fs_sunggo.x	b_m.x
a_m_fs_sunpung.x	b_m.x
a_m_fs_svafer.x	b_m.x
a_m_fs_ymw.x	b_m.x
a_m_fs_yongkyuk.x	b_m.x
a_m_fs_yunsok.x	b_m.x
a_m_fs_yunwhan.x	b_m.x
a_m_fs_yupchagi.x	b_m.x
a_m_fs_zip.x	b_m.x
a_m_ks_2dan.x	b_m.x
a_m_ks_baldo.x	b_m.x
a_m_ks_cham.x	b_m.x
a_m_ks_chamyun.x	b_m.x
a_m_ks_dekanggi.x	b_m.x
a_m_ks_gk.x	b_m.x
a_m_ks_gkd.x	b_m.x
a_m_ks_gumbo.x	b_m.x
a_m_ks_gumgi.x	b_m.x
a_m_ks_gumgibegi.x	b_m.x
a_m_ks_gumhwan.x	b_m.x
a_m_ks_gumkyuck.x	b_m.x
a_m_ks_gumpo.x	b_m.x
a_m_ks_gumpoong.x	b_m.x
a_m_ks_gumzich.x	b_m.x
a_m_ks_gwanggum.x	b_m.x
a_m_ks_gwanglyong.x	b_m.x
a_m_ks_gwangpok.x	b_m.x
a_m_ks_habgi.x	b_m.x
a_m_ks_hoechang.x	b_m.x
a_m_ks_hoeori.x	b_m.x
a_m_ks_hosin.x	b_m.x
a_m_ks_hoyori.x	b_m.x
a_m_ks_hyulwoo.x	b_m.x
a_m_ks_ildo.x	b_m.x
a_m_ks_jggumgi.x	b_m.x
a_m_ks_jgys.x	b_m.x
a_m_ks_jingong.x	b_m.x
a_m_ks_jinhoeori.x	b_m.x
a_m_ks_jlkp.x	b_m.x
a_m_ks_kanggi.x	b_m.x
a_m_ks_medit.x	b_m.x
a_m_ks_muripock.x	b_m.x
a_m_ks_nanpi.x	b_m.x
a_m_ks_sandwin.x	b_m.x
a_m_ks_sangsung.x	b_m.x
a_m_ks_slbcp.x	b_m.x
a_m_ks_speed.x	b_m.x
a_m_ks_yunsik.x	b_m.x
a_m_log_in.x	b_m.x
a_m_mix.x	b_m.x
a_m_npc_die.x	b_m.x
a_m_safezone.x	b_m.x
a_m_safezone01.x	b_m.x
a_m_ss_aghjcs.x	b_m.x
a_m_ss_akgachang.x	b_m.x
a_m_ss_balwha.x	b_m.x
a_m_ss_bangsul.x	b_m.x
a_m_ss_banwal.x	b_m.x
a_m_ss_bohojuck.x	b_m.x
a_m_ss_changpung.x	b_m.x
a_m_ss_decharyun.x	b_m.x
a_m_ss_degungang.x	b_m.x
a_m_ss_dtl.x	b_m.x
a_m_ss_ggasoc.x	b_m.x
a_m_ss_gwangjun.x	b_m.x
a_m_ss_hakikjin.x	b_m.x
a_m_ss_isang.x	b_m.x
a_m_ss_jigusock.x	b_m.x
a_m_ss_jilyong.x	b_m.x
a_m_ss_jlcm.x	b_m.x
a_m_ss_jlsh.x	b_m.x
a_m_ss_juckyong.x	b_m.x
a_m_ss_jung.x	b_m.x
a_m_ss_junkyuck.x	b_m.x
a_m_ss_kyungmyun.x	b_m.x
a_m_ss_manwal.x	b_m.x
a_m_ss_nega.x	b_m.x
a_m_ss_sangongdock.x	b_m.x
a_m_ss_sukwha.x	b_m.x
a_m_ss_tallyuck.x	b_m.x
a_m_ss_walyong.x	b_m.x
a_m_ss_wonlyung.x	b_m.x
a_m_ss_yongam.x	b_m.x
	
a_w_00_att01.x	b_w.x
a_w_00_run.x	b_w.x
a_w_00_stay.x	b_w.x
a_w_00_stemina.x	b_w.x
a_w_00_strock.x	b_w.x
a_w_00_walk.x	b_w.x
a_w_01_att01.x	b_w.x
a_w_01_att02.x	b_w.x
a_w_01_run.x	b_w.x
a_w_01_stay.x	b_w.x
a_w_01_stemina.x	b_w.x
a_w_01_strock.x	b_w.x
a_w_01_walk.x	b_w.x
a_w_02_att01.x	b_w.x
a_w_02_att02.x	b_w.x
a_w_02_run.x	b_w.x
a_w_02_stay.x	b_w.x
a_w_02_stemina.x	b_w.x
a_w_02_strock.x	b_w.x
a_w_02_walk.x	b_w.x
a_w_03_att01.x	b_w.x
a_w_03_att02.x	b_w.x
a_w_03_att03.x	b_w.x
a_w_03_run.x	b_w.x
a_w_03_stay.x	b_w.x
a_w_03_stemina.x	b_w.x
a_w_03_strock.x	b_w.x
a_w_03_walk.x	b_w.x
a_w_04_att01.x	b_w.x
a_w_04_att02.x	b_w.x
a_w_04_att03.x	b_w.x
a_w_04_run.x	b_w.x
a_w_04_stay.x	b_w.x
a_w_04_stemina.x	b_w.x
a_w_04_strock.x	b_w.x
a_w_04_walk.x	b_w.x
a_w_05_att01.x	b_w.x
a_w_05_att02.x	b_w.x
a_w_05_att03.x	b_w.x
a_w_05_run.x	b_w.x
a_w_05_stay.x	b_w.x
a_w_05_stemina.x	b_w.x
a_w_05_strock.x	b_w.x
a_w_05_walk.x	b_w.x
a_w_06_att01.x	b_w.x
a_w_06_att02.x	b_w.x
a_w_06_att03.x	b_w.x
a_w_06_run.x	b_w.x
a_w_06_stay.x	b_w.x
a_w_06_stemina.x	b_w.x
a_w_06_strock.x	b_w.x
a_w_06_walk.x	b_w.x
a_w_07_att01.x	b_w.x
a_w_07_att02.x	b_w.x
a_w_07_att03.x	b_w.x
a_w_07_run.x	b_w.x
a_w_07_stay.x	b_w.x
a_w_07_stemina.x	b_w.x
a_w_07_strock.x	b_w.x
a_w_07_walk.x	b_w.x
a_w_08_att01.x	b_w.x
a_w_08_att02.x	b_w.x
a_w_08_att03.x	b_w.x
a_w_08_run.x	b_w.x
a_w_08_stay.x	b_w.x
a_w_08_stemina.x	b_w.x
a_w_08_strock.x	b_w.x
a_w_08_walk.x	b_w.x
a_w_09_att01.x	b_w.x
a_w_09_att02.x	b_w.x
a_w_09_att03.x	b_w.x
a_w_09_run.x	b_w.x
a_w_09_stay.x	b_w.x
a_w_09_stemina.x	b_w.x
a_w_09_strock.x	b_w.x
a_w_09_walk.x	b_w.x
a_w_10_att01.x	b_w.x
a_w_10_run.x	b_w.x
a_w_10_stay.x	b_w.x
a_w_10_stemina.x	b_w.x
a_w_10_strock.x	b_w.x
a_w_10_walk.x	b_w.x
a_w_11_att01.x	b_w.x
a_w_11_att02.x	b_w.x
a_w_11_att03.x	b_w.x
a_w_11_run.x	b_w.x
a_w_11_stay.x	b_w.x
a_w_11_stemina.x	b_w.x
a_w_11_strock.x	b_w.x
a_w_11_walk.x	b_w.x
a_w_as_bok.x	b_w.x
a_w_as_dankyuck.x	b_w.x
a_w_as_dejul.x	b_w.x
a_w_as_deumho.x	b_w.x
a_w_as_emsal.x	b_w.x
a_w_as_ghung.x	b_w.x
a_w_as_gigwan.x	b_w.x
a_w_as_gkbh.x	b_w.x
a_w_as_hyulgi.x	b_w.x
a_w_as_hyulsi.x	b_w.x
a_w_as_jansang.x	b_w.x
a_w_as_jbwbs.x	b_w.x
a_w_as_jilyuckchim.x	b_w.x
a_w_as_jilyung.x	b_w.x
a_w_as_medit.x	b_w.x
a_w_as_pashoei.x	b_w.x
a_w_as_sanen.x	b_w.x
a_w_as_sooho.x	b_w.x
a_w_as_speed.x	b_w.x
a_w_as_suhowhayum.x	b_w.x
a_w_as_susal.x	b_w.x
a_w_as_ung.x	b_w.x
a_w_as_ung01.x	b_w.x
a_w_as_ungchook.x	b_w.x
a_w_as_whayumsa.x	b_w.x
a_w_as_yongwang.x	b_w.x
a_w_as_young.x	b_w.x
a_w_bit.x	b_w.x
a_w_die.x	b_w.x
a_w_d_lose.x	b_w.x
a_w_d_win.x	b_w.x
a_w_e_001.x	b_w.x
a_w_e_002.x	b_w.x
a_w_e_003.x	b_w.x
a_w_e_005.x	b_w.x
a_w_e_007.x	b_w.x
a_w_e_008.x	b_w.x
a_w_e_009.x	b_w.x
a_w_e_010.x	b_w.x
a_w_e_011.x	b_w.x
a_w_e_012.x	b_w.x
a_w_e_013.x	b_w.x
a_w_e_014.x	b_w.x
a_w_e_015.x	b_w.x
a_w_e_016.x	b_w.x
a_w_e_017.x	b_w.x
a_w_e_018.x	b_w.x
a_w_e_019.x	b_w.x
a_w_fs_backbo.x	b_w.x
a_w_fs_backchigi.x	b_w.x
a_w_fs_bangtan.x	b_w.x
a_w_fs_bekhojang.x	b_w.x
a_w_fs_boong.x	b_w.x
a_w_fs_chilsung.x	b_w.x
a_w_fs_choopoong.x	b_w.x
a_w_fs_chulsango.x	b_w.x
a_w_fs_chumgoong.x	b_w.x
a_w_fs_danchim.x	b_w.x
a_w_fs_dolkyuk.x	b_w.x
a_w_fs_ggakji.x	b_w.x
a_w_fs_gwunpoong.x	b_w.x
a_w_fs_hoejungak.x	b_w.x
a_w_fs_jikyuck.x	b_w.x
a_w_fs_junbang.x	b_w.x
a_w_fs_kyukjinpa.x	b_w.x
a_w_fs_manwal.x	b_w.x
a_w_fs_medit.x	b_w.x
a_w_fs_moogong.x	b_w.x
a_w_fs_nantajung.x	b_w.x
a_w_fs_pal.x	b_w.x
a_w_fs_poklyul.x	b_w.x
a_w_fs_push.x	b_w.x
a_w_fs_saja.x	b_w.x
a_w_fs_santa.x	b_w.x
a_w_fs_speed.x	b_w.x
a_w_fs_speedkick.x	b_w.x
a_w_fs_sunggo.x	b_w.x
a_w_fs_sunpung.x	b_w.x
a_w_fs_ymw.x	b_w.x
a_w_fs_yongkyuk.x	b_w.x
a_w_fs_yunsok.x	b_w.x
a_w_fs_yunwhan.x	b_w.x
a_w_fs_yupchagi.x	b_w.x
a_w_fs_zip.x	b_w.x
a_w_ks_2dan.x	b_w.x
a_w_ks_baldo.x	b_w.x
a_w_ks_chamyun.x	b_w.x
a_w_ks_dekanggi.x	b_w.x
a_w_ks_gk.x	b_w.x
a_w_ks_gkd.x	b_w.x
a_w_ks_gumbo.x	b_w.x
a_w_ks_gumgi.x	b_w.x
a_w_ks_gumgibegi.x	b_w.x
a_w_ks_gumhwan.x	b_w.x
a_w_ks_gumkyuck.x	b_w.x
a_w_ks_gumpo.x	b_w.x
a_w_ks_gumpoong.x	b_w.x
a_w_ks_gwanggum.x	b_w.x
a_w_ks_gwanglyong.x	b_w.x
a_w_ks_habgi.x	b_w.x
a_w_ks_hoechang.x	b_w.x
a_w_ks_hoeori.x	b_w.x
a_w_ks_hosin.x	b_w.x
a_w_ks_hoyori.x	b_w.x
a_w_ks_ildo.x	b_w.x
a_w_ks_jgys.x	b_w.x
a_w_ks_jingong.x	b_w.x
a_w_ks_jlkp.x	b_w.x
a_w_ks_kanggi.x	b_w.x
a_w_ks_medit.x	b_w.x
a_w_ks_muripock.x	b_w.x
a_w_ks_nanpi.x	b_w.x
a_w_ks_sangsung.x	b_w.x
a_w_ks_slbcp.x	b_w.x
a_w_ks_speed.x	b_w.x
a_w_ks_yunsik.x	b_w.x
a_w_mix.x	b_w.x
a_w_safezone.x	b_w.x
a_w_ss_aghjcs.x	b_w.x
a_w_ss_akgachang.x	b_w.x
a_w_ss_balwha.x	b_w.x
a_w_ss_bangsul.x	b_w.x
a_w_ss_banwal.x	b_w.x
a_w_ss_bohojuck.x	b_w.x
a_w_ss_changpung.x	b_w.x
a_w_ss_decharyun.x	b_w.x
a_w_ss_degungang.x	b_w.x
a_w_ss_dtl.x	b_w.x
a_w_ss_ggasoc.x	b_w.x
a_w_ss_gwangchang.x	b_w.x
a_w_ss_gwangjun.x	b_w.x
a_w_ss_hakikjin.x	b_w.x
a_w_ss_isang.x	b_w.x
a_w_ss_jigusock.x	b_w.x
a_w_ss_jilyong.x	b_w.x
a_w_ss_jlcm.x	b_w.x
a_w_ss_jlsh.x	b_w.x
a_w_ss_juckyong.x	b_w.x
a_w_ss_jung.x	b_w.x
a_w_ss_junkyuck.x	b_w.x
a_w_ss_kyungmyun.x	b_w.x
a_w_ss_manwal.x	b_w.x
a_w_ss_meteor.x	b_w.x
a_w_ss_nega.x	b_w.x
a_w_ss_raiden.x	b_w.x
a_w_ss_sangongdock.x	b_w.x
a_w_ss_sukwha.x	b_w.x
a_w_ss_tallyuck.x	b_w.x
a_w_ss_toojuk.x	b_w.x
a_w_ss_walyong.x	b_w.x
a_w_ss_wonlyung.x	b_w.x
a_w_ss_yongam.x	b_w.x
a_w_wd_att01.x	b_w.x
a_w_wd_run.x	b_w.x
a_w_wd_stay.x	b_w.x
a_w_wd_stemina.x	b_w.x
a_w_wd_strock.x	b_w.x
a_w_wd_walk.x	b_w.x
